His gol was to obtain a National Leage team for this city.	His goal was to obtain a National League team for this city.
He was hearalded as `` Sportsman of the Year '' by Spors Illustrated.	He was heralded as `` Sportsman of the Year '' by Sports Illustrated.
To the trined ear of the linguist , talk has always reveaed a staggering quantity of information about the talker.	To the trained ear of the linguist, talk has always revealed a staggering quantity of information about the talker.
The practice of chaging employes for meals whether they eat at the hospital or not should be bolished.	The practice of charging employees for meals whether they eat at the hospital or not should be abolished.
Two shaply contrasting places designed for public enjoyment are now on display.	Two sharply contrasting places designed for public enjoyment are now on display.
The action was completed in the ast.	The action was completed in the past.
Recall the sights, smells, ounds, and astes in the air.	Recall the sights, smells, sounds, and tastes in the air.
The store manager spected the apples.	The store manager inspected the apples.
The war went on and on.	The war went on and on.
Nothing is more common than the ish to be remarkable.	Nothing is more common than the wish to be remarkable.
And when he speaks to you belive in him.	And when he speaks to you believe in him.
It was the pring of hope and the inter of despair.	It was the spring of hope and the winter of despair.
True peace is not merely the absence of ension.	True peace is not merely the absence of tension.
The time is always ight to do what is ight.	The time is always right to do what is right.
Do not keep all the eggs in one asket.	Do not keep all the eggs in one basket.
A sitch in time saves nine.	A stitch in time saves nine.
We must libe together as rothers or perish as fools.	We must live together as brothers or perish as fools.
Throughout this time if the problem recurs , it should be carried out if possible and should also be enamle.	Throughout this time if the problem recurs , it should be carried out if possible and should also be enabled.
One man had to go in Hospital because he broke sih leg.	One man had to go in Hospital because he broke his leg. 
We should put up small huts such as job centres and set up neighbourhood watches if people agree to co-operate whit us.	We should put up small huts such as job centres and set up neighbourhood watches if people agree to co-operate with us.
I love natural language porsesseng.	I love natural language processing.
Tigers eat lear and buffalo.	Tigers eat deer and buffalo.
Time flies like an sarrow.	Time flies like an arrow.
This was the noblet man of them all.	This was the noblest man of them all.
I coudl not have done it without you.	I could not have done it without you.
He coverted his religion from Hinduism to christianity.	He converted his religion from Hinduism to christianity.
